root	Admin	OTRS	1
sz	Сабыр	Жакипов	1
durussov	Денис	Урусов	1
bsidorov	Борис	Сидоров	1
dchernetskiy	Дмитрий	Чернецкий	2
ddedik	Дмитрий	Дедик	2
dz	Денис	Зайковский	1
ekurm	Ерик	Курмангалиев	1
emilenin	Егор	Миленин	2
ggaak	Геннадий	Гаак	1
idedik	Ирина	Дедик	1
asabitov	Аян	Сабитов	2
os	Олег	Соловьев	1
rinat	Ринат	Беркимбаев	2
sautalipov	Сабит	Ауталипов	2
sk	Сергей	Курячий	2
vsh	Виталий	Шаховцев	2
vzh	Виталий	Жильцов	1
mos	Максим	Осадчук	2
dsuhonosov	Данил	Сухоносов	2
office	Лариса	Сирока	1
nsamarenko	Никита	Самаренко	2
mkochnev	Михаил	Кочнев	2
azv	Арман	Азимбаев	1
defanov	Денис	Ефанов	2
vvitiker	Виталий	Витикер	2
amelnikov	Антон	Мельников	2
ami	Алексей	Мищенко	1
ormanov	Олжас	Орманов	2
adorogov	Александр	Дорогов	1
bor	Берик	Ортбаев	2
mpog	Михаил	Погадаев	1
dzd	Дархан	Жолдасбаев	1
mkropachev	Михаил	Кропачев	1
sgorbachev	Cтанислав	Горбачев	1
vbauer	Виктор	Бауэр	1
glukyanov	Григорий	Лукьянов	1
akalabashkin	Александр	Калабашкин	1
akulygin	Алексей	Кулыгин	1
ylyssenko	Евгений	Лысенко	1
yshirshov	Евгений	Ширшов	1
asolodovnikov	Алексей	Солодовников	1
aavgumbayev	Абай	Авгумбаев	1
emarkabayev	Ерлик	Маркабаев	1
tnaumov	Тимофей	Наумов	1
ykoshenov	Ербол	Кошенов	1
tsultanov	Талгат	Султанов	1
vsm	Вячеслав	Смольников	2
ahab	Бахтияр	Мейрманов	2
rtol	Рахат	Толегенов	2
myrza	Жандос	Мырзаханов	2
aset	Асет	Жандильдин	1
azhuravlev	Артем	Журавлев	2
abdraimovz	Замир	Абдраимов	2
bz	Бакытжан	Рамазанов	1
sstacenko	Сергей	Стаценко	1
mvedelyanchikov	Михаил	Веделянчиков	1
iolkhovoy	Илья	Ольховой	1
arusskikh	Александр	Русских	1
achigvincev	Антон	Чигвинцев	2
adokdyrkhan	Алмаз	Докдырхан	1
pmukhai	Павел	Мухай	1
bgaliullin	Булат	Галиуллин	1
ashirshov	Александр	Ширшов	1
kurussov	Константин	Урусов	1
ymorozov	Юрий	Морозов	1
afrolov	Алексей	Фролов	2
ylevin	Юрий	Левин	1
ddolotin	Данил	Долотин	1
sladeishchikov	Сергей	Ладейщиков	1
balimakynov	Бахытжан	Алимакынов	2
